011100000000000g
010000000000000g
010000000000000g
011111000000000g
000100000000000g
000101111100000g
000100001000000g
010111010000000g
001010010100000g
001000000111111g
000000000001000g
011111110001000g
000000000000000g
000000000000000g



