011000000000110g
010011110111111g
010000000000000g
011111000000010g
000100000000010g
000101111100011g
000100111000010g
110000010000010g
000111010100000g
000100000111111g
000000000001000g
011111111001000g
000000000001011g
001111110001000g
000000000000000g
011111100000000g

